{
  "version": 1,
  "width": 20,
  "height": 10,
  "used_terrain_types": [
    "Plain",
    "Low Mountain",
    "Medium Mountain",
    "High Mountain",
    "Hill",
    "Shallow Ocean"
  ],
  "terrain_type_map": [
    "0,0,1,1,1,1,1,1,2,2,2,2,2,2,2,2,1,1,1,1",
    "0,1,1,1,2,2,2,2,2,2,3,3,3,3,3,2,2,2,2,2",
    "1,1,2,2,2,2,2,3,3,3,3,2,2,2,3,3,3,3,3,3",
    "1,2,2,3,3,3,3,3,2,2,2,2,2,2,2,2,2,2,2,2",
    "2,2,3,3,2,2,2,2,2,1,1,1,1,1,1,1,1,1,1,1",
    "2,3,3,2,2,2,1,1,1,1,4,4,4,1,1,4,4,4,4,4",
    "2,2,2,2,1,1,1,4,4,4,4,4,4,4,4,4,4,4,4,4",
    "1,1,1,1,4,4,4,4,0,0,0,0,4,4,4,4,4,0,0,0",
    "1,1,4,4,4,0,0,0,0,5,5,0,0,0,0,0,0,0,5,5",
    "4,4,4,0,0,0,0,0,5,5,5,5,0,0,0,0,0,5,5,5"
  ]
}