{
  "version": 1,
  "width": 20,
  "height": 10,
  "used_terrain_types": [
    "Low Mountain",
    "Hill",
    "Plain",
    "Medium Mountain",
    "High Mountain"
  ],
  "terrain_type_map": [
    "0,0,0,0,0,1,1,1,1,1,1,1,1,1,2,2,2,2,2,2",
    "0,0,3,3,0,0,0,1,1,0,0,0,0,1,1,1,1,2,2,2",
    "1,0,3,3,3,3,3,0,0,0,0,0,0,0,0,0,1,2,2,2",
    "1,0,0,3,4,3,3,4,4,3,3,3,3,3,2,0,1,1,2,2",
    "1,1,0,3,4,4,4,4,3,3,0,0,0,3,3,0,0,1,2,2",
    "2,1,0,3,3,3,3,3,0,0,0,1,0,0,3,0,0,1,2,2",
    "2,1,0,0,0,0,0,0,0,1,1,1,1,0,3,0,1,1,2,2",
    "2,1,1,1,1,1,1,1,1,1,2,2,1,0,3,0,1,2,2,2",
    "2,2,2,2,2,2,2,2,2,2,2,2,1,0,0,0,1,2,2,2",
    "2,2,2,2,2,2,2,2,2,2,2,2,1,1,1,1,1,2,2,2"
  ]
}